{
    "width": 9,
    "height": 9,
    "boxes": [
    [0, 3, 0, 0, 1, 0, 0, 3, 0],
    [0, 1, 0, 1, 1, 1, 0, 1, 0],
    [0, 1, 0, 0, 0, 0, 0, 1, 0],
    [0, 1, 0, 2, 0, 2, 0, 1, 0],
    [0, 1, 0, 1, 0, 1, 0, 1, 0],
    [0, 1, 0, 1, 0, 1, 0, 1, 0],
    [0, 1, 0, 1, 0, 1, 0, 1, 0],
    [0, 2, 0, 1, 0, 1, 0, 2, 0],
    [0, 0, 0, 3, 0, 3, 0, 0, 0]],
    "tanks": [[0.5, 0.5, 0], [8.5, 0.5, 0]],
    "flag": [4.5, 8.5]
}